0  XXXXXXXXXXXXXXXX
1  XSX0X0000000XX0X
2  X0X000XXXXX0X00X
3  X0X0X0XXXX00X0XX
4  X0X0X0X00000000X
5  X000X0X0X0XXXXXX
6  X0X0X0X0X000000X
7  X0X0XXX0X0XXXXXX
8  X0X000X00000000X
9  X0X0X0X0XXXXX00X
10 XXX0XXX0X000000X
11 X000X000X0XXXXXX
12 X0XXX0X0X000000X
13 X0X000XXXXX0XX0X
14 X0000XX000000XGX
15 XXXXXXXXXXXXXXXX